0,0,0,0,0,0,0,0,0,0,0,0,0,0,0,0,0,0,0,2
0,0,0,0,0,0,0,0,2,0,0,0,0,0,0,0,0,0,0,2
0,0,2,2,0,0,0,0,0,0,0,2,2,0,2,2,0,0,0,2
0,0,0,0,0,0,8,0,0,0,0,0,0,0,0,0,0,0,0,2
0,0,0,0,0,8,2,0,0,8,0,0,0,0,0,0,0,0,0,2
2,2,8,8,5,2,2,8,5,2,5,8,8,5,8,5,8,0,0,2
2,1,1,1,1,1,1,1,1,1,1,1,1,1,1,1,1,0,0,2
2,0,0,0,0,0,0,0,0,0,0,0,0,0,0,0,0,0,0,2
2,0,0,0,0,0,0,0,0,0,0,0,0,0,0,0,0,2,0,2
2,4,0,0,2,0,0,0,0,0,0,0,2,0,0,0,0,0,0,2
2,5,5,5,2,0,0,5,5,8,8,8,2,8,8,8,5,5,8,2
2,1,1,1,1,8,8,1,1,1,1,1,1,1,1,1,1,1,1,2
