2,2,2,2,6,2,2,2,2,2,2,2,2,2,2,2,2,2,2,2
2,0,0,2,0,0,0,0,0,5,0,0,0,5,5,0,6,6,6,2
2,0,4,2,0,2,2,2,2,1,0,0,0,1,1,5,0,0,0,2
2,0,2,2,0,6,2,2,1,1,8,8,5,9,1,1,7,0,9,2
2,0,2,7,0,0,0,9,1,1,1,1,1,1,1,1,2,0,9,2
2,0,2,2,2,7,0,0,5,0,0,0,0,0,0,0,0,0,9,2
2,0,2,2,7,0,0,9,1,0,0,0,2,2,7,0,2,8,2,2
2,0,2,2,7,0,0,1,1,8,0,0,0,9,2,2,2,2,2,2
2,0,6,0,0,0,9,1,1,2,0,8,0,0,0,0,0,0,0,0
2,0,0,0,0,5,0,1,1,0,0,2,0,9,2,0,0,0,2,2
2,0,5,5,8,1,8,1,1,7,0,5,5,9,2,5,0,0,0,2
2,8,1,1,1,1,1,1,1,1,8,1,1,1,1,1,8,8,8,2
