2,2,2,2,0,0,0,0,0,0,0,0,0,0,0,0,0,0,0,2
2,0,0,2,0,0,0,0,0,0,0,0,0,0,0,0,0,0,0,2
2,0,4,2,0,0,0,0,0,0,0,0,0,0,0,0,0,0,0,2
2,0,2,2,0,0,0,0,0,0,0,0,0,0,0,0,0,0,0,2
2,0,2,0,0,0,0,0,0,0,0,0,0,0,0,0,0,0,0,2
2,0,2,0,0,0,0,0,0,0,0,0,0,0,0,0,0,0,0,2
2,0,2,3,0,0,0,0,0,0,0,0,0,0,0,0,0,0,0,2
2,0,2,2,0,0,0,3,0,0,0,0,0,0,0,0,0,0,0,2
2,0,2,0,0,0,0,1,0,0,0,0,0,0,0,0,0,0,0,2
2,0,0,0,0,5,0,1,0,0,0,0,0,0,0,0,0,0,0,0
2,0,5,5,3,1,3,1,5,5,5,5,5,5,5,5,5,5,5,0
2,3,1,1,1,1,1,1,1,1,1,1,1,1,1,1,1,1,1,2
